"filename", "language", "JavaScript", "JSON", "HTML", "CSS", "comment", "blank", "total"
"e:\毕业设计\E-reader-server\index.js", "JavaScript", 301, 0, 0, 0, 29, 3, 333
"e:\毕业设计\E-reader-server\model\HistoryModel.js", "JavaScript", 96, 0, 0, 0, 5, 0, 101
"e:\毕业设计\E-reader-server\model\InsertBookToBookshelfModel.js", "JavaScript", 30, 0, 0, 0, 1, 1, 32
"e:\毕业设计\E-reader-server\model\InsertHistoryModel.js", "JavaScript", 83, 0, 0, 0, 6, 1, 90
"e:\毕业设计\E-reader-server\model\ReadModel.js", "JavaScript", 66, 0, 0, 0, 4, 0, 70
"e:\毕业设计\E-reader-server\model\ResgModel.js", "JavaScript", 58, 0, 0, 0, 4, 2, 64
"e:\毕业设计\E-reader-server\model\SearchBookshelfModel.js", "JavaScript", 96, 0, 0, 0, 5, 1, 102
"e:\毕业设计\E-reader-server\model\SearchbookModel.js", "JavaScript", 247, 0, 0, 0, 7, 2, 256
"e:\毕业设计\E-reader-server\model\UserModel.js", "JavaScript", 77, 0, 0, 0, 3, 3, 83
"e:\毕业设计\E-reader-server\multerUtil.js", "JavaScript", 12, 0, 0, 0, 2, 2, 16
"e:\毕业设计\E-reader-server\package-lock.json", "JSON", 0, 753, 0, 0, 0, 1, 754
"e:\毕业设计\E-reader-server\package.json", "JSON", 0, 21, 0, 0, 0, 1, 22
"e:\毕业设计\E-reader-server\public\dist\index.html", "HTML", 0, 0, 15, 0, 0, 3, 18
"e:\毕业设计\E-reader-server\public\dist\static\css\app.c7ac833693bdcd3a4ce7920f302e9502.css", "CSS", 0, 0, 0, 1, 0, 0, 1
"e:\毕业设计\E-reader-server\public\dist\static\js\app.fc5f657ca2944fde35d0.js", "JavaScript", 1, 0, 0, 0, 0, 0, 1
"e:\毕业设计\E-reader-server\public\dist\static\js\manifest.2ae2e69a05c33dfc65f8.js", "JavaScript", 1, 0, 0, 0, 0, 0, 1
"e:\毕业设计\E-reader-server\public\dist\static\js\vendor.d636e10726ebf235d771.js", "JavaScript", 6, 0, 0, 0, 27, 0, 33
"e:\毕业设计\E-reader-server\service\HistoryService.js", "JavaScript", 29, 0, 0, 0, 2, 0, 31
"e:\毕业设计\E-reader-server\service\InsertBookToBookshelfService.js", "JavaScript", 50, 0, 0, 0, 6, 1, 57
"e:\毕业设计\E-reader-server\service\InsertHistoryService.js", "JavaScript", 35, 0, 0, 0, 3, 0, 38
"e:\毕业设计\E-reader-server\service\ReadService.js", "JavaScript", 29, 0, 0, 0, 2, 0, 31
"e:\毕业设计\E-reader-server\service\ResgService.js", "JavaScript", 28, 0, 0, 0, 2, 3, 33
"e:\毕业设计\E-reader-server\service\SearchBookService.js", "JavaScript", 101, 0, 0, 0, 0, 2, 103
"e:\毕业设计\E-reader-server\service\SearchBookshelfService.js", "JavaScript", 29, 0, 0, 0, 1, 1, 31
"e:\毕业设计\E-reader-server\service\UserService.js", "JavaScript", 29, 0, 0, 0, 2, 0, 31
"e:\毕业设计\E-reader-server\util\DBUtil.js", "JavaScript", 9, 0, 0, 0, 0, 0, 9
"e:\毕业设计\E-reader-server\util\jwt.js", "JavaScript", 34, 0, 0, 0, 4, 4, 42
"Total", "-", 1447, 774, 15, 1, 115, 31, 2383